111111111111
110000001E11
1C0101C01001
110001110101
1C11C0000001
100P10101001
110000C01C11
11111111 111
