111111111111
11P000001E11
1C0101C01001
110001110101
1C11C0000001
100P10101001
110000C01C11
111111111111
