111111111111
110000001E11
100101001001
110001110101
101100000001
100P10101001
110000001011
111111111111
