111111111111
110000001E11
1C0101C01001
110001110101
1C11C0000001
100P00101001
111111111111

111111111111
110001110101
111111111111
