111111111111
110000001E11
1C0101C01001
110001110101
1C11C0000001
1000P0101001
110110C01C11
111111111111
