111111111111
110000001E11
1C0100C00001
110010P00011
1C10C0010001
100010000011
110111C11C11
111111111111
