11111111111
110000001E1
1C010000001
1100101P001
111C0010001
10001000001
11111111111
