111111111111
110000001E11
1C0100C11101
110000110001
1C11C1000001
100P00010011
110111C11C11
111111111111
