11111111111111111111111111111111
11000000101000001010010000001011
1C0101C0100101C010010C0101CE1001
11000101010001010101010001010101
1010C0000001C00000011010C0000001
10001010100010101001100010101001
110000C0101000C01010010000C01011
110000C0101000C01010010000C01011
110000C0101000C01010010000C01011
11000000101000001010010000001011
1C0101C0100101C010010C0101C01001
11000101010001010101010001010101
1010C0000001C00000011010C0000001
10001010100010101001100010101001
110000C0101000C01010010000C01011
110000C0101000C01010010000C01011
110000C0101000C01010010000C01011
11000000101000001010010000001011
1C0101C0100101C010000C0101C01001
11000101010001010101010001010101
1010C0000001C00000011010C0000001
10001010100010101001100010101001
110000C0101000C01010010000C01011
110000C0101000C01010010000C01011
110000C0101000C01010010000C01011
11000000101000001010010000001011
1C0101C0100101C010010C0101C01001
11000101010001010101010001010101
1010C0000001C00000011010C0000001
100P1010100010101001100010101001
110000C0101000C01010010000C01011
11111111111111111111111111111111
