111111111111111111111111111111111111111111111111
1P11000000110000001100000110000001100000011000E1
101001100010011000100110010011000100110001001101
100011010000110100001101000110100001101000011011
111000010110000101100001110000101100001011000011
101010101010101000101010010101000101010001010101
10001001C0001000C00010000001000C0001000C00010001
1000C000100C000000C000000C000000C000000C00000001
101100110011001100110011011001100110011001100111
101100000011000000110000011000000110000001100001
101001100010011000100110010011000100110001001101
100011010000110100001101000110100001101000011011
111000010110000101100001110000101100001011000011
101010100010101000101010010101000101010001010101
10001000C0001000C00010000001000C0001000C00010001
101100110011001100110011011001100110011001100111
101100000011000000110000011000000110000001100001
101001100010011000100110010011000100110001001101
100011010000110100001101000110100001101000011011
111000010110000101100001110000101100001011000011
1000C000000C000000C000000C000000C000000C00000001
101010100010101000101010010101000101010001010101
10001000C0001000C00010000001000C0001000C00010001
101100110011001100110011011001100110011001100111
101100000011000000110000011000000110000001100001
101001100010011000100110010011000100110001001101
100011010000110100001101000110100001101000011011
1000C000000C000000C000000C000000C000000C00000001
111000010110000101100001110000101100001011000011
101010100010101000101010010101000101010001010101
10001000C0001000C00010000001000C0001000C00010001
111111111111111111111111111111111111111111111111
