1111111
1P000E1
100C001
1000001
100C001
1000001
1000001
100C001
1000001
1000001
100C001
1111111
