1111111111111111
1PCCCCCCCCCCCCC1
1CCCCCCCCCCCCCC1
1CCCCCCCCCCCCCC1
1CCCCCCCCCCCCCC1
1CCCCCCCCCCCCCC1
1CCCCCCCCCCCCCC1
1CCCCCCCCCCCCCC1
1CCCCCCCCCCCCCC1
1CCCCCCCCCCCCCC1
1CCCCCCCCCCCCCC1
1CCCCCCCCCCCCCC1
1CCCCCCCCCCCCCC1
1CCCCCCCCCCCCCC1
1CCCCCCCCCCCCCE1
1111111111111111
