111111111111111
111111111111111
111111111111111
111CCCCECCCC111
111C1111111C111
111C1000001C111
111C1011101C111
111C1011101C111
111C1011101C111
111C1000001C111
111C1111111C111
111CCCCPCCCC111
111111111111111
111111111111111
111111111111111
