111111111111111
100000000000001
101111111111101
101CCCCCCCCC101
101C1111111C101
101C1000001C101
101C1011101C101
101P1010101E101
101C1011101C101
101C1000001C101
101C1111111C101
101CCCCCCCCC101
101111111111101
100000000000001
111111111111111
